1111111111111111111111111111111111
1E00000000000000000000000000000001
1010010100100000101001000001111101
101001001T1010100010010000000101C1
1P0000000000000000000T000000000101
1111111111111111111111111111111111
