1111111111111111111111111111111111
1E00000000000000000000000000000001
1010010100100000101001000001111101
10100100101010100010010000000101C1
1P00000000000000000000000000000101
1111111111111111111111111111111111
